angry_face	rất tệ
anguished_face	tệ
anxious_face_with_sweat	bình_thường
astonished_face	tệ
beaming_face_with_smiling_eyes	rất tốt
confounded_face	bình_thường
confounded_face_hugely	rất tệ
confused_face	tệ
crying_face	rất tệ
disappointed_but_relieved_face	rất rất tệ
disappointed_face	rất tệ
dizzy_face	bình_thường
downcast_face_with_sweat	tệ
expressionless_face	tệ
face_blowing_a_kiss	rất tốt
face_savoring_food	rất tốt
face_savouring_delicious_food	rất tốt
face_screaming_in_fear	bình_thường
face_throwing_a_kiss	rất tốt
face_with_cold_sweat	tệ
face_with_head-bandage	tệ
face_with_look_of_triumph	rất tệ
face_with_medical_mask	tốt
face_with_open_mouth	bình_thường
face_with_open_mouth_and_cold_sweat	rất tệ
face_with_rolling_eyes	bình_thường
face_with_steam_from_nose	rất tệ
face_with_stuck_out_tongue_and_winking_eye	tốt
face_with_tears_of_joy	rất rất tốt
face_with_thermometer	rất tệ
face_with_tongue	tốt
face_without_mouth	bình_thường
fearful_face	tệ
flushed_face	bình_thường
frowning_face	tệ
frowning_face_with_open_mouth	bình_thường
grimacing_face	tệ
grinning_face	tốt
grinning_face_with_big_eyes	rất rất tốt
grinning_face_with_smiling_eyes	tốt
grinning_face_with_sweat	rất tốt
grinning_squinting_face	rất rất tốt
hugging_face	tốt
hushed_face	bình_thường
kissing_face	rất rất tốt
kissing_face_with_closed_eyes	rất tốt
kissing_face_with_smiling_eyes	rất rất tốt
loudly_crying_face	rất tệ
money-mouth_face	tốt
bình_thường_face	bình_thường
pensive_face	tệ
persevering_face	tệ
pouting_face	rất tệ
relieved_face	tốt
sad_but_relieved_face	rất tệ
sleeping_face	bình_thường
sleepy_face	tệ
slightly_frowning_face	tệ
slightly_smiling_face	tốt
smiling_face	tốt
smiling_face_with_halo	tốt
smiling_face_with_heart-eyes	tốt
smiling_face_with_heart_shaped_eyes	rất rất tốt
smiling_face_with_open_mouth	rất tốt
smiling_face_with_open_mouth_and_cold_sweat	tốt
smiling_face_with_open_mouth_and_smiling_eyes	rất rất tốt
smiling_face_with_open_mouth_and_tightly_closed_eyes	rất tốt
smiling_face_with_smiling_eyes	tốt
smiling_face_with_sunglasses	tốt
smirking_face	tệ
squinting_face_with_tongue	tốt
thinking_face	tốt
tired_face	rất tệ
unamused_face	tệ
upside-down_face	bình_thường
weary_face	rất tệ
winking_face	tốt
winking_face_with_tongue	tốt
worried_face	rất tệ
zipper-mouth_face	tệ
red_heart	rất tốt
broken_heart	tệ
sparkling_heart	tốt
vkl	rất tệ
đmm	rất tệ
tks	tốt